22222222
22222222
22222222
22222222
22222222
22222222
22222222
22522222
55555555
55555555
55555555